WWWWWWWWWWWWWWWWWWWWWWWWWWWWWWWWWWWWWWWWWWWWWWWWWWWWWWWWWWWWWWWWWWWWWWWWWWWWWWWW
W ## W @@        b                                                             W
W ## W           W   W                                                         W
W    W           W   W                                                         W
W    WWWWWWWWWWWWW   WWWWWWWWWWWWWWWW   WWWWWWWWWWWWWWWWWWWWWWWWWWWWWWWWWWWWWWWW
W                                                                              W
W                                                                              W
W                                                                              W
W                                                                              W
W                                                                              W
W                                                                              W
W                                                                              W
W                                                                              W
W                                              WWWWWWWWWWWWWWWWW               W
W                                              W               W               W
W                                       W      c    W          WWWW            W
W                                       WWWWWWWWWWWWW             W            W
W                                             a                   W            W
W                                W            aa           W  X   W            W
W                                WWWWWWWWWWWWWWWWWWWWWWWWWWWWWWWWWW            W
W                                                                              W
WWWWWWWWWWWWWWWWWWWWWWWWWWWWWWWWWWWWWWWWWWWWWWWWWWWWWWWWWWWWWWWWWWWWWWWWWWWWWWWW
W  &                                                                           W
W                                                                              W
WWWWWWWWWWWWWWWWWWWWWWWWWWWWWWWWWWWWWWWWWWWWWWWWWWWWWWWWWWWWWWWWWWWWWWWWWWWWWWWW